4 4 4 4 4 4 
4 4 4 4 5 4
4 0 0 2 5 4
4 0 0 0 2 4
4 1 0 0 0 4
4 4 4 4 4 4