4 4 0 5 5
0 0 0 5 0
0 2 3 2 0
1 0 0 0 0
