4 4 4 5
0 0 0 5
0 3 2 0
1 0 0 0
